000000000000000000000000000000000000000000000000000003000000000000000000000000000000000000011100000000000000000000000100011100000000003000000000001110010000000000000000000000001110010000000000000000000000001010000000000000000000000000000000000000000000000000000000000000000111000000000000000000101000000111000000000000000000111000000110000000000000000000111000000101000000000000000000101000000000000000000000000000000000000000000000000000000000000000000000010000000000000101000000000000111000000000000111000000000000111000000000000111000000000000101000000000000101000000000000000001110001000000000000000000000001100011100000000000000000000000110011100000000000000000000001110010100000000000000000000000000000000000000000000000000000000000000000000000
000000000000000000000000000000000000000000000000000000000000011111111111110000000000000000000000000000000000000000200000000000000000000000200000000000000000000000000000000000000000000000000000000000000000000000000200000200011111111111111110000000000000000000000000000000000000000000000000000000000000000000000000000000000000000000000000000000000000000000000000000000000000000000000000000000011111111111111110000002000000000000000000000000000000000000000000000000000000000000000000000020000000000000000000000000000000000000000000200000000000000000020000000000000000000000000000000000111111111111111110000000000000000000000000000000000000000000000000000000000000011111111111110000020000020000000000000000000000000000000000000000000000000000000000000000
000000000000000000000000000000000000000000000000000000000000000000001000000100000000010000011000000000000110002000000000011000020000000011000000000000000000000000200000000000000000000020000000000002000000200000010000010001000000000000000000000000000000000000000000100000000100000000000010000000000000000000000000000000000000020000000000000000000000000000000000000020000001000020000010000000001000000000000000000000000000000000000020000000000000000000000000000001000001000000001000000000000011100000000020111100000010000011100000000000011000000000000000000000000000000000000000000000000000000000000000002000000000200010000001002000000001000000000000000111000000000001100000100000002111000000000000000000000000000000000000000000000000000000000000000000
000000000000000000000000000000000000000000000000000000000000000000000020000000111100000000000110000000001000100000011000000110000000011000000020001000000000010000011000000110001000000000010000000000001110001000000100211000000020000000000000001100000000000000000000020000000100000001110000000111000000000000000000000000000001000000000000000000000000000000000000000001110000200000100002000000000001100000100011100000000000000000100001100000000000011000000000000000000000000000111000000200000000000110200000110000000000000200001110000000000000000000100000001100000002000200000011100000000000000000000000000011000000000002000000011000000000000100200000000100111000000000000111000000001100000000000000000000000000001000000000000000000000000000000000000000
000000000000000000000000000000000000000000000000000000000000000000010000200000000000000000000000010000000000011111000000001000000000000000000011000000001100000001111000000000000000001110000001111100000000200000000110000001100000001000000100000000000000000000011110001100000000020000000020011110001000000000000000000000011110000000000000000111000000000110000000000011000011000000000000000000000111000000000002000000200000000111000000000000000000000000000011000200000000001000000000000000000000000000001000001000000000000000000010000000111000000000010000000111000000111000000000111000000011100001111000001000011100200011100001111000001000011110000000102001110000000000000000000000000000000000000000000000000000000000000000000000000000000000000000000000
000000000000000000000000000000000000000000000000000000000000000000110000000000000011000000000000000000000000000111100000000000000000011100000000000000000100200000111000000000200000001100000000000000000000000000001100000000000000000001110000001100001000000200000011000000000000011000000000000111000000000000011100000000000111000000000000011100000000001111000000000000000000000000000000000000000020000000100200000000200000000000000001100000010000000000000000010000000000010000000000000011110000000000000000010000000111110000000000000001110000000000000020011000000001110000000000000000011111000001110000000001100000010011100000000000000111111000000000000000000000000000000000000000000000000000000000000000000200000001100000000000000000000000000000000000
000000000000000000000000000000000000000000000000000000000000000000000000000000000000000000000000000000001111000020000000000011000000001111000000000000000111110000011111100000000000000000000000000011100000011000000000000000000001000000111000002000000000000000000001111000000000000000000000000011110000000001000020000000000011110000000011100000000000002000000000000011100000000000000000000000000011111000011100000000000000000011111000011110000000000000000000000000011110000000000000000000020000000000000200011000000000000000000000000001111000002000111110000011110001111000000001111110002011100011111000000001111111000011000011110000000001111111000010000000000000000001000000000000000000000000000000000000000000000000000000000000000000000000000000000000
000000000000000000000000000000000000000000000000000000000000000000000000000000000000000000000000000020000002000000000000000000000000000000000101000000000000111100000000000111100000000000111111111000000111100000000011111111110000000111100000000000000000000000000000000000000000000000000000000000000000000000020000000020000000200000000000000000000000000000000000000000000000000100000000000000000000000000000100010000000000000002000000001111111000020000000000000000011111111000000000000000000000000000000000000000000000000000000000000000000000000000000000000000000000000000000001100002000000020110000000000111110000000000000111111100000111111000000000000111111000000011110000000000000001111000000000000000000000000000000000000000000000000000000000000000
000000000000000000000000000000000000000000000000000000000000000000000000000000000020000000000000000000000000000000000000000000101000002000000000000000000000111000000000000011000000000001111100000000000111100000000201111100000010000011110000000000111000000111000001100000000000000000000011000000000000000000000000000000000000000000000000000002000000000000000000000010000000000000000000000000000111100000001000000020000000000000000000000000000000000000000000001000000000011000000000000200011100000001111000000000000000001110000001111100200000000001000100000000000000000000000001100000020000000000000000000000110000000000000011000000000000000000000000000001100000000000000000000000000001000000000000000000000000000000000000000000000000000000000000000000
000000000000000000000000000000000000000000000000000000000000000000000000001000000000000000000000000000011111000000000000000000000000011110002000000000000010000000000000000000110000000111100000000000000011111000000111102000020000000011111000000001100000000000000000011000000000100000000000000000000000000000000000000010000000000000000000000001100011100200000000000000000001100011100000000000000000002001100011100000000000000000000011000001100000000000000001100010000000000000000000000111110000000000000000200000000111000000200000001010000000000111000000000000011111000000000000000000010000011111110000000000000001110002000010000000000000000011110000000000000000000200000000000000000000000000000000000000000000000000000000000000000000000000000000000000
000000000000000000000000000000000000000000000000000111110000000000000000000000200111111000000000000000111110000001110000000111100000000110000001110000000111100200000000000000110000000111100000000000000001110000000111000000000000200000000000000111000000000000000000000000000110000011111110000000000000000000000001111111000000000000000000000111100011100000020000000000001111100011100000000000000002001111100011000000001000000000000011100011000000001100000000000011100110000000001100000000000000100100000200011100000000000000000000000000011100000000002000000200000000011100000000000000000000000001111000001111100000001000000001101000001111110000011111110000000000000011110000001111110000000000000000000000000000000000000000000000000000000000000000000000
