000000000000000000000000000000000000000000000000000000000000000000000000000000000000000000000000000000000000000000000000000000000000000000000000000000000000000000000000000000002000000000000000000000000000000000000002000200020002000200000000000000000000000000000000000000000000000000000000000000000000000000000000000000000000000000000000020000200200020020000000000000000000000000000000000000000000000000000000000000000000000000000000000000000000002000000000000000000000000000000000000000000000000000000000000000000002000002000002000020002000000000000000000000000000000000000000000000000000000000000000000000000000000000000000000000000000000000000000000000000000000000000000000000000000000000000000000000000000000000000000000000000000000000000000000000
000000000000000000000000000000000000000000000000000000000000000000000000000000000000000000000000000000000002000000000000000000000000000000000000000000011100000000000000000000000100011100000000000000000000001110010000000000000000000000001110010000000000000000000000001010000000000000000000000000000000000111000000000000000000101000000111000000000000000000111000000110000000000000000000111000000101000000000000000000101000000000000000000000000000000000000000001000000000001010000000000000011100000000001110000000000000011100000000001110000000000000010100000000001010000000000000000001110001000000000000000000000001100011100000000000000000000000110011100000000000000000000001110010100000000000000000000000000000000000000000000000000000000000000000000000
000000000000000000000000000000000000000000000000000000000000111111111111110000000000000000000000000000000000000000200000000000000000000000200000000000000000000000000000000000000000000000000000000000000000000000000200000200011111111111111111000000000000000000000000000000000000000000000000000000000000000000000000000000000000000000000000000000000000000000000000000000000000000000000000000000111111111111111110000002000000000000000000000000000000000000000000000000000000000000000000000020000000000000000000000000000000000000000000200000000000000000020000000000000000000000000000000000111111111111111111000000000000000000000000000000000000000000000000000000000000111111111111110000020000020000000000000000000000000000000000000000000000000000000000000000
000000000000000000000000000000000000000000000000000000000000000000001000000100000000010000011000000000000110002000000000011000020000000011000000000000000000000000200000000000000000010020000000000002000000200000000000010001000000000000000000000000000000000000000000100000000100000000000010000000000000000000000000000000000000020000000000000000000000000000000000000020000001000020000010000000001000000000000000000000000000000000000020000000000000000000000000000001000001000000001000000000000011100000000020111100000010000011100000000000011000000000000000000000000000000000000000000000000000000000000000002000000000200010000001002000000001000000000000000111000000000001100000100000002111000000000000000000000000000000000000000000000000000000000000000000
000000000000000000000000000000000000000000000000000000000000000000000020000000001100000000000110000000001000001000011000000110000000011000000020001000000000010000011000001110001000000000010000000000000110001000000100211000000020000000000000001100000000000000000000020000000100000001110000000111000000000000000000000000000001000000000000000000000000000000000000000001010000200000100002000000000001100000100001100000000000000000100001100011000000011000000000000000000000000000111000000200000000001110200000110000000000000200000110000000000000000000100000000000000002000200000011100000000000000000000000000011000000000002000000011000000000000100200000000100111000000000000111000000001100000000000000000000000000001000000000000000000000000000000000000000
